W,W,W,Q,W,W,W,W,W,W
W,,,P,,,,,D,W
W,,,,,,B,B,,W
W,,W,W,B,,W,W,,W
W,,W,W,,,W,W,B,W
W,,D,,W,W,D,D,,W
W,,,W,W,W,W,,,W
W,,,W,W,W,W,,,W
W,,,W,,,W,,,W
W,W,W,W,W,W,W,W,W,W
