W,W,W,W,W,W,W,W,W,W
W,B,,,W,,,,,W
W,,P,,W,D,W,,,W
W,,,,W,W,W,,,W
W,,,,B,,,,,W
W,,,,B,,,,,W
W,,,,,,,,,W
W,,W,W,,,,,,W
W,,D,W,,,,,,Q
W,W,W,W,W,W,W,W,W,W