W,W,Q,W,W,W,W,W,W,W
W,,,,W,,,,,W
W,,,P,W,D,W,,,W
W,,,,,W,W,W,,W
W,W,,,,,,,,W
W,W,,B,,B,,B,,W
W,,,,,W,W,B,,W
W,,W,,W,D,W,B,,W
W,,,,W,,,,,W
W,W,W,W,W,W,W,W,W,W